SO cubfiles/xpm/p_ji_s_1.xpm
WE cubfiles/xpm/p_ji_w_1.xpm
NO cubfiles/xpm/p_ji_n_1.xpm
EA cubfiles/xpm/p_ji_e_1.xpm
S cubfiles/xpm/p_ji_c_1.xpm
R 302 101
C 3,178,200
F 0, 120, 255

111111111111111
101000100010001
11000010101010101
1010001010100010
110N0010101010101
10110010101010101
111111111111111
