SO cubfiles/xpm/p_ji_s_1.xpm
WE cubfiles/xpm/p_ji_w_1.xpm
NO cubfiles/xpm/p_ji_n_1.xpm
EA cubfiles/xpm/p_ji_e_1.xpm
S cubfiles/xpm/p_ji_c_1.xpm
R 1024 800
C 3,178,200
F 0, 120, 255

S111111111
1000000001
1010000101
1000000101
1002000001
1000020001
1000000101
1010N00101
1000000001
1111111111
