SO cubfiles/xpm/p_ji_s_1.xpm
WE cubfiles/xpm/p_ji_w_1.xpm
NO cubfiles/xpm/p_ji_n_1.xpm
EA cubfiles/xpm/p_ji_e_1.xpm
S cubfiles/xpm/p_ji_c_1.xpm
R 300 100
C 3,178,200
F 0, 120, 255

111111111111111
100000000000001
100000000000001
1N000000000000
111111111111111
